When I listen = Quand j'écoute
Could you speak more slowly, please? = Pourriez-vous parler plus lentement s'il vous plaît?
Could you repeat the question, please? = Pourriez-vous répéter la question, s'il vous plaît?
Can you repeat that, please? = Pouvez-vous répéter ça, s'il vous plaît?
I didn’t understand. = Je n'ai pas compris
Sorry what did you say? = Désolé qu'est-ce que tu as dit?
Sorry I don’t understand. = Désolé je ne comprends pas
Sorry, I didn’t hear the question. = Désolé, je n'ai pas entendu la question
I wasn’t listening = Je n'écoutais pas
Could you speak up, please? = Pourriez-vous parler plus fort, s'il vous plaît?
When I read = Quand je lis
What is the meaning of this word, please? = Quel est le sens de ce mot, s'il vous plaît?
Could you explain this word, please? = Pourriez-vous expliquer ce mot, s'il vous plaît?
What does the word “hello” mean, please? = Que signifie le mot « bonjour » , s'il vous plaît?
When I speak = Quand je parle
How do you say “bonjour” in English, please? = Comment dites-vous «bonjour» en anglais, s'il vous plaît?
What’s the English for “bonjour”? = Quel est l’anglais pour «bonjour»? 
I’m not sure but … = Je ne suis pas sûr mais…
I don’t know exactly but … = Je ne sais pas exactement mais…
To Guess = deviner
I want to explain it in English but it’s difficult = Je veux l’expliquer en anglais mais c’est difficile
I’m sorry, I have left my copybook at home = Je suis désolé, j'ai laissé mon cahier à la maison
When I write = Quand j'écris
Could you write it on the board, please? = Pourriez-vous l'écrire au tableau, s'il vous plaît?
Could you spell this word, please? = Pourriez-vous épeler ce mot, s'il vous plaît?
Can = may = pouvoir
Could = verbe can mais au futur/conditionel = pourrai
May I close the blinds, please ? = Puis-je fermer les stores, s'il vous plaît?
We can’t see whats’ written = Nous ne pouvons pas voir ce qui est écrit
Excuse me, what is the word (or the letter) before/after … = Excusez-moi, quel est le mot (ou la lettre) avant / après…
Sorry, I can’t read what’s on the board = Désolé, je ne peux pas lire ce qui est sur le tableau
When we debate = Quand on débat
I agree with you  = je suis d’accord avec toi
I agree with what (he,she,you ...) said = Je suis d'accord avec ce que (il, elle, vous ...) a dit
To Share = partager
I share the same opinion as « Mary » = Je partage la même opinion que «Mary»
I don’t agree with you = Je ne suis pas d'accord avec toi
I disagree with what (he,she,you ...) said = Je ne suis pas d'accord avec ce que (il,elle, tu ...) a dit
I think “Mary” is wrong = Je pense que "Mary" a tort
“Mary” made a mistake because she/he said … and I think … = “Mary” a fait une erreur parce qu'elle / il a dit… et je pense…
I think that … = Je pense que …
In my opinion … = À mon avis …
As far as I am concerned … = En ce qui me concerne …
Same = même
Pour les phrases affirmatives
Some + one = quelqu’un
                          Thing = quelque chose
                          Where = quelque part
Pour les phrases négatives
“Some” devient “Any”
Rappel :
Verbe + ing = nom ou adjectif
Nom + ly = adverbe
Want = vouloir
Want + to + verbe infinitif
I want to swim = je veux nager 
I want you to swim = je veux que tu nages 



Hot = chaud
Cold = froid
Angry = en colère
Hungry = qui a faim
Happy = content
Sad = triste
Tired = fatigué
Tiring = fatiguant
Messy = désordonnée
Tidy = rangé, ordonné
Scary = effrayant
Afraid = avoir peur
Fine = bien
Funny = marrant, drôle
Smart = intelligent / cleaver = intelligent
Bored = ennuyé               	boring = ennuyant, ennuyeux
Depressed = dépressif, déprimé
Worried = inquiet 
Confident = confiant
Stressed = stressé
Excited = excité
Delighted = ravi, enchanté, très heureux
Feel/ felt / felt = sentir
Some = quelque
Silly = loufoque, absurde
Nerves = nerf
Really = vraiment
Quite = assez
Quiet = silencieux
Brainstorm = lancer des idées
Express = exprimer
Yourself = toi même
Leave me alone = laisse-moi tranquille
Can i read = puis-je lire
You should have said … = vous auriez dû dire …
Do I have to read ? = Dois-je lire ?
Let ‘ s start again = Recommençons.
I haven’t finished to write = je n’ai pas fini d’écrire
Winter = hiver
Spring = printemps
Summer = été
Autumn = automne
Holidays = vacances, congés ( I’m on holidays )
Over = au dessus / terminer
Le encore
					
Still	Again	Not yet
Toujours	De nouveau	Pas encore
Avant le verbe
Après be
Après les auxiliaire	En fin de phrases	En fin de phrases
Le not : verbe
Le yet : fin de phrase
I’m still at home
Je suis encore à le maison	I will do it again
Je le referais	I have not finished yet
Je n’ai pas encore fini


As well = aussi (comparaison) , ( too and also )
As well as = ainsi que
Les questions
Yes, No question	Wh- ? 
On ne peut répondre que par oui ou non	On doit répondre en formant une phrase 
Do I have read
Yes, you do / No, you don’t	What’s your name ?
My name is …

Already = déjà
Obvious = évident 
Justify = justifier
Prove = prouver
Actually = en fait, en realité
Document = Document
Cartoon = dessin animé, humoristique 
Comic strip = bande dessinée
Magazine = magazine
Author = auteur
Count = compter	to rely on = compter sur (qql)
Write / wrote / written = écrire
Written = écrit
Writer = écrivain
Characters = personage
Only = seulement
First = premièrement
Finally = finalement
Then = ensuite
Blue = bleu / le cafard, déprimer
Down = en bas / déprimer
Last = dernier
At last = enfin		at least = au minimum
Alone = seul
Anymore = de nos jours, (ne…) plus
Look + adj = sembler, paraître, avoir l’air

Next = prochain 































Cool = cool
Strange = étrange
Weird = bizarre
Full of energy = plein d’énergie
Shy = timide
Hardworking = travailleur
Available = disponible
Communicative = communicatif
Creative = creatif
Curious = curieux
Always= toujours
Usually = généralement
Often = souvent
Sometimes = quelque fois
Never = jamais
A la toisième personne au present simple, le s deviant es devant -ch -sh -o -ss -x
I’ve got a headache = j'ai mal à la tête
Headache = mal de tête
Get / got / gotten = obtenir
Le verbe avoir en anglais
Have	Have got
Un état permanant	Exprime la possession
Les caractéristiques ( physiques, liens de parenté, …)

Un état temporaires
Have not
Haven’t	Have not got
Haven’t
Do + sujet + have	Have + sujet + got
Do + sujer + have got


Can stand = pouvoir, supporter 
Les Articles
0	A / An	The
Singulier / Pluriel	Singulier	Singulier / Pluriel
Des généralités	Un élément inderterminé	Un ou des éléments précis
“des”	“un,une”	“le,la,les”

Le Génitif
Schéma :
Personne qui possède	‘ s	Chose possédée
‘ s :
Grand parents ‘ house	Lucie ‘s and Tom ‘s notebook	Lucie and Tom ‘s cat
La maison des grands parents	Le cahier de lucie et le cahier de Tom	Le chat de lucie et Tom
Devant un nom qui se termine par un “s” le  ‘s  devient ‘	Ils possèdent tous les deux un notebook
! un chaqu’un !	Ils ont le même chat

COMPARATIF   plus … que ER THAN
•	Adjectif court : 1 syllabe
			       2 syllabes finissant par y ou er
				ADJ + ER  THAN
			      I ‘ m younger than you
			Je suis plus jeune que toi
Adj finissant par y  i 		easy : easier
		Consonne / Voyelle / Consonne  On double la dernière consonne
				Big  Bigger
•	Adjectif long : autres adjectifs à 2 syllabes
    3 syllabes et plus
				MORE + ADJ + THAN
			This date is more important than this one
			Cette date est plus importante que celle ci
•	Si on remplace more par less : plus  moins

SUPERLATIF  le plus THE EST
	Adjectif court :  the  adj + est
I’m the youngest of the family
Je suis le plus jeune de la famille
	Adjectif long : the most + adj
This date is the most important of this country
Cette date est la plus importante dans ce pays
	Si on remplace most par least : le plus  le moins

3 ADJECTIFS IRREGULIERS

Good / Better than / The best
Bon / meilleur que / le meilleur
Far / Farther than ou further than / The farthest ou the furthest
Loin / plus loin que / le plus loin
Bad / Worse than / The worst
Mauvais / plus mauvais que / le pire

If = si
Around = autour de
Friendly : aimable, sympa
                                                                       At the top : en haut


     On the left : sur la gauche           On the right : sur la droite

	(be) at the bottom : en bas
                                                                                Avec be : être a l’origine de …
                                                                                                Au fond de … / au pied de …
Middle : milieu
Nasty : méchant
Wicked : méchant
Bad : mauvais
Hair : cheveux
Eye : oeuil
Nose : nez
Mouth : bouche 
Chin : menton
Neck : cou
Beard : barbe
Shape : forme
 


Round : rond                          rectangular : rectangle                pointed : pointu
Sea : la mer
Bear : ours
Castle : chateau
Arrow : fleche
Light : lumière
Battle : bataille
King : roi
Prince : prince
Knight : chevalier
Witch : sorcière
Hold / held / held : tenir
Fight / fought / fought : lutter, se batter
Attack : attaquer, une attaque
Protect : proteger
Cast / cast / cast : jeter, lancer (ex : cast a spell, jeter un sort)
Spell : sort
Wardrobe : armoire
Hide / hid / hidden : cacher
Meet / met / met : rencontrer
Meal : repas
	QUI :
 – WHO : pour une personne
 --   WHICH : pour le reste  
Another day : un autre jour
The other days : les autres jours
On the right : sur la droite
On the left : sur la gauche
Perhaps : peut-être
Maybe : peut-être
So : très, tellemnt ( so young, très/ tellement jeune)
Probably : probablement
How : comment
How to + verbe infinitif : comment faire pour …
How to cook : comment faire pour cuisine
There is + nom singulier : il y a
There are + nom pluriel : il y a
Ceiling : plafond
To work in pair : travailler a deux
To work in groups : travailler en groupes
To comb : peigner
To have breakfast : prendre son petit déjeuner
To have lunch : prendre son dejeuner
To have dinner : prendre son diner
To have a shower / bath : prendre une douche / un bain
To wake up : se réveiller
To get up : se lever
To get dressed : s’habiller
To go to school : aller a l’école
To study : étudier
Students : étudiant
To do my homework : faire mes devoirs
To go back home : revenir a la maison
To brush my teeth : se brosser les dents
Tooth : dent
Teeth : dents
On + un jour : pour designer 1 jour précis
Monday : lundi
Tuesday : mardi
Wednesday : mercredi
Thursday : jeudi
Friday : vendredi
Saturday : Samedi
Sunday : dimanche
Lunchtime : heure du repas
Why : pourquoi
When : quand 
Where : où
What : que quoi dans une question, ce que ce qui le reste
How : comment
Who : qui
English : anglais
French : français
Spanish : espagnol
German : allemand
History : histoire
Geography : geographie
Art : art
Drama : drame/théâtre
Music : musique
Maths : math
Science : science 
Chemistry : chimie
Physics : physique
Biology : biologie
It (information technology) : technologie
Pe (physical education) : sport
Drums : batterie
Guitar : guitare
Piano : piano
To bore : s’ennuyer
Boring : ennuyeux
Interesting : interessant
To Finish : fini
To remember : se souvenir
Junk food : mauvaise nourriture, cochonneries, “malbouffe”
Big : gros
Small : petit
Fat : épais
Thin : fin
Tall : grand
Little : petit
Healthy : en bonne santé
To Heal : guérir
Sweet : sucré
School canteen(s) : cantine
To do sport : faire du sport
Calorie : calorie
Fruit : fruit
Overweight : en surpoids, trop lourd
Excess weight : excès de poids
Weight : poids (masse)
Fast food : fast food
Chips : frite
Burger : burger
Pizza : pizza
French fries :
Potato(es) : pomme de terre 
Soda : soda
Drink : boisson   		To drink : boire
Beverages : boisson
Processed : industriel, traité, transformé
Processed food : nourriture industriel 
Expensive :  chère
Vending machines : distributeur(automatique)
Frozen food : produits/nourritures surgelé(e)s
Obese(adj) : obèse
Obesity : obésité
Put on weight : prendre du poids
Gain extra kilos : prendre des kilos
Fast food restaurant : restaurant rapide
Salt : sel
Sugar : sucre
Fake food : fausse nourriture
Short life : courte vie
Life : vie
Live : vivre
Health problems : problèmes de santé
Heart problems : problème cardiovasculaire/de cœur
Diabetes : diabète
(Not) Healthy : (pas) bon pour la santé
To feed/fed/fed : nourrire
To swallow : avaler
To eat/ate/eaten : manger
Unwell : souffrant
Fattening food : nourriture qui fait grossir
Find/found/found : trouver
Under : sous, en dessous
Place : endroit, lieu
Food products : produits alimentaires
People : gens, personnes
Student(s) : étudient(s)
Teen(s) : ado(s)
Family : famille 		families : familles
Friend : ami
Child : enfant   		children : enfants
Kid : enfant, gamin
Causes : les causes
Not expensive : pas chère 
Cheap : pas chère, bon marché
Leaflet : prospectus
Newspaper(s) : journal(aux)
Addictive : addictif
Lack on time : manque de temps
Lack : manque, pénurie
Advertising : publicité
Commercial on T.V. : pub de télé
Consequence(s) : conséquence(s)
Short life : courte vie 
Solution(s) : solution(s)
Diet : régime
Go on a diet follow : suivre un régime
Vegetable : légume
Describe : décrire
Analyse : analyser
Introduce : présenter (qql to qql)
Type : type
Origin : origine
Topic or subject : sujet ou sujet
Part : partie
General impression : impression générale
Use : utiliser
Present continuous : le présent continu 
Context : contexte
Reaction : réaction
Give/gave/given : donner
Opinion : opinion
Awareness : conscience
Campaign : campagne
Extent : étendue
Aware of : conscient de
Aware : attentif
Dangers : danger
Night mares : cauchemars
What happens : que se passe-t-il
To happen : se passer
Saddle : selle
Rope : corde
Shield : bouclier
Sword : épée
Helmet : casque
To make fun of : se moquer de …
Sheeps : mouton
To trap : piéger
To be trapped : être piégé
To have fun : s’amuser
Clean : propre
Lively : vivant/ animé
Colourful : coloré
Motorbike : moto
Be careful : faire attention/ être prudent






Painting : peinture 
Poster : poster, affiche
Ad : pub 		
Advert : publicité
Photo : photo
To cover : couvrir
Cover of magazine : couverture du magazine
Website homepage : page d'accueil du site
Homepage : page d’accueil
Drawing : dessin
Picture : image
This picture is entitled … : cette image est intitulée…
The title of this comic strip is … : le titre de cette bande dessinée est…
The document comes from … : le document vient de…
The document was taken from a magazine … : le document provient d'un magazine…
It was published in … : il a été publié dans…
It was drawn (or painted) by … : il a été dessiné (ou peint) par…
The document is about … : le document est à propos de…
It shows … : il montre …
It represents … : il représente …
It deals with … : ça parle de …
To deal/dealing/dealt : 
To represent : représenter
General impressions : impressions générales
We can see/notice : on peut voir / remarquer
To notice : remarquer
The scene takes place in a city, in the countryside … : la scène se passe dans une ville, à la campagne…
The main characters are … : les personnages principaux sont …
Main : principal
ON UTILISE LE PRESENT CONTINUS (BE + V-ING) POUR DÉCRIRE UNE IMAGE.
To interpret : interpréter
We can easily imagine than … because … : nous pouvons facilement imaginer que… parce que…
As we can see …, we can deduce that … : comme on peut le voir…, on peut en déduire…
The artist’s intention : l'intention de l'artiste
The artist wants to make us understand that … : l'artiste veut nous faire comprendre que…
The artist want to show that … : l'artiste veut montrer que…
I think the artist wants to show that … : Je pense que l'artiste veut montrer que…
The aim of the artist is probably to … : Le but de l'artiste est probablement de…
Aim : but, objectif
Artist : artiste
Give my opinion : donner mon opinion
I think this picture is quite (+ adjective) because … : Je pense que cette image est assez (+ adjectif) parce que…
What I find surprising/incredible/amazing is that … : Ce que je trouve surprenant / incroyable / étonnant, c'est que…
What strikes/shocks/surprises me in this cartoon is that … : Ce qui frappe / surprend / me surprend dans cette dessin, c'est que…
Useful adjectives : ajectifs utiles
Shocking : boulversant, troublant
Funny : drôle
Ironic : ironique
Original : original
Convincing : convaincant
Provocative : provocant
Exaggerated : exagéré
Frightening : effrayant
Moving : émouvant
Humorous : comique
Witty : amusant
Straightforward : simple
Fortunately : heureusement		Unfortunately : malheureusement
Therefore : donc 
To continue : continuer (to, de)
Keep + verbe-ing : continuer à, de …
Quick : rapide 
As : comme (sans comparaison)
Like : comme(quand on fait une comparaison)
In case of : en cas de
To exist : exister 
To compose : composer
Part : part, partie
Sick : malade
Sickness : maladie
	Le que :
Than : dans les comparaisons
That : le reste
Risk : risque
Sort : sorte 
Addict : addict
Habit : habitude
To change : changer
To replace : remplacer
Dessert : dessert
	Pour faire qql chose :
To + v (infinitive)
For + v-ing 
To own : possèder
Own : proper (“le mien …”)
Slumped : affalé 		To slump : s’affaler
Sofa : canapé
Balanced : équilibré
Past : après

Les auxiliaires de modalité :
Le modaux donnent des renseignement (informations supplémentaires) :
	You { can } go to the cinema
	          Must…
 Les auxiliaires de modalités sont invariables et sont toujours suivit du verbe (B.V base verbal) :
	He cans to go to the cinema
Can/can’t : pouvoir
Can/could/could : pouvoir	sert à dire ce que l’on peut faire ou ce que l’on sait faire	I can swim : je peux nager
Could (« l » muet) : pourrait	Sert à faire une suggestion, une demande polie ou une possibilité future	you could go to the cinema : tu pourrais aller au cinema
could you go to the cinema : pourrais-tu eller au cinema

May : se peut (50%)	Demande polie ou très forte probabilité (50%)	It may rain tonight : il va probablement pleuvoir ce soir

Might  se pourrait (25%)	Probabilité faible (25%)	I might call you tonight : je pourrais peut être (25%) t’appelé ce soir.
Must/Mustn’t : devoir, doit	L’obligation ou l’interdiction	I must speak to my boss : je dois parlé avec mon patron
Will	Exprime le futur	I will be a musician one day : je serais un musicien un jour.
Would : will au passé (« l » muet)	Habitude dans la passée ou le conditionnel	When i was a kid, i would wake up at 7.00 o’clock : quand j’étais petit je me levé à 7 heures.
Should : devrait (« l » muet)	Donne un conseil	You should go to bed : tu devrais aller au lit

Tonight : ce soir
All day long : toute la journéé
Advice : conseil
Many : beaucoup de
To contain : contenir
Instead : à la place, au lieu de
Bullied : harcelé 	to bully : harceler
Harassed : épuiser 	victim of discrimination : victime de discrimination 
To advise : conseiller
It’s better for … to … : c est meilleur pour … de …
If I were him, I would “change”… : si je serez lui, je {verbe au conditionnel} “changerai”
I advice him to … : je lui conseille de …
On strike : en grève
Few : peu de …
Seat : place (siege)
Way back home : chemin de retour
Untidied : pau soigné, mal range
In a mess : en désordre
Brake light : feu de freinage
Honey : miel, chéri
About : à propos de …
About to + verbe à l’infinitif : sur le point de …
Slice : tranche, part
Cut back on : réduire
To strengthen : renforcer
Reason : raison
To climb on : monter sur , monter
To Rise/Rose/Risen : augmenter, monter
Weighing scales : balance(de poid) / scale : balance
To calm : calmer
Limit : limite 			To limit : limiter
Consumption : consommation
Chemical : chimique
Money : monnaie, argent
Outside : dehors
Reshaping : remise en forme
Age : âge
To risk : risquer 		risk : risque
Re + verbe : refaire
Redo : refaire
Sadly : hélas
Gift : cadeau
Receipt : ticket de caisse, reçu, recette (somme encaissée)
Recipe : recette (de cuisine)
To enjoy : apprécier
Budget : budget
Month : mois
If not : sinon
To avoid : éviter
Need to + B.V. : avoir besoin de …
To tell/told/told : raconter
Right : juste, correct
Lifestyle : style de vie
	Le future :
Le Futur Simple  	Le Futur Proche
Will / Won’t + B.V.	Be going to + B.V.
Action que l’on pense réaliser
	Action sûr








Ever : jamais
To classify : classifier, classer
Young : jeune
Lazy : paresseux
Absent-minded : tête en l’air
Clumsy : maladroit
Yesterday : hier
Today : aujourd’hui
Tomorrow : demain
Workmate : collègue (de travail)
Organist : organiste
Association : association
	Le Même :
-Same : quand on compare
-Even : le reste
To implement : metre en oeuvre
To target : cibler
Specific : spécifique
Group : groupe 
Everywhere : partout
Plate : assiette
Supermarket : supermarché
To separate : séparer
Explanation : explication
To discover : découvrir
Conference : conférence
To influence : influencer
Staff : personnel (employé)
To defend : défendre
Struggle : lutte 				to struggle : avoir du mal, lutter
Against : contre
To convince : convaincre
Training : formation
To deserve : mériter
You deserve it : tu le mérites
Either … or … : soit … , soit …
Either you say : soit tu dis
Relevant : pertinent, compétent
Proud : fier (of,de)
From now on : désormais, à partir de maintenant 
Consumer : consomateur
Pocket money : argent de poche
Shopping : (faire des) courses
Books/cinema : livres/cinéma
Gift : cadeaux						Present : cadeau
Clothes : vêtements
Outings : sorties (activités extérieurs)
To way to : façon de faire
Hobby : passion
To prefer : préférer
Obsession : obsession
Whenever : n’importe quand
	This or these : cela, ce, cette …
This : suivit d’un mot au singulier
These : suivit d’un mot au pluriel
Near : près de
Almost : presque
Town centre : centre-ville				 Town : ville
Downtown : centre-ville
Business : commerce (revenu)
Trade : commerce (échange)
To survive : survivre
Store : magasin
Carbon copy : copie conforme
To wet : mouiller
Shame : honte
Busy : occupé
Stuff : truc, chose
To deliver : délivrer
To order : commander (passer une comande)			Order : commande, ordre
To command : commander (diriger)
Crowd : foule
Queue : queue
Artificial atmosphere : atmosphère artificielle 
Nation : pays
To turn into : se transformer en, se transformer
Survey : enquête
Poll : sondage
Behaviour : comportement
To develop : développer
Variety : variété
Unpleasant : désagréable
Day off : jour de congé
However : cependant
Though : cependant
Office : bureau
To match : associer
To hurry up : se dépêcher
To take a rest : faire une pause
Mud : boue
To soak : tremper
To bleach : blanchir 			            
Stain : tâche
To swear/swore/sworn : jurer
Matter : matière
What’s the matter with … : quel est le problème avec ….
Hail : grêle
To suppose : supposer
Chorus : refrain
High : haut, élevé
Glad : content, ravi
To back : reculer  				    To be back : être de retour
Client : client
Customer : client, consomateur
Casino :	 casino				Gambling games : jeux d’argent
Price : prix
Cost : coûter, coût
Keep money : garder de l’argent
Wage : salaire
Salary : salaire
Control : contrôle			To control : contrôler, manipuler
Think twice before buying : réfléchir deux fois avant d’acheter
Twice : deux fois
Decision : décision				  attitude : attitude, comportement
What he needs really : ce qu’il a vraiment besoin
Spends his money wisely : il dépense son argent sagement
Money is not falling from the sky : l’argent ne tombe pas du ciel
Particular : précis, particulier
Much : beaucoup (de)
To prevent : empêcher, éviter
Joke shop : magasin de farce et attrapes
I totally agree : je suis entièrement d'accord
I strongly believe that … : je crois fermement que …
I definitely think that … : je pense vraiment que …        		Definitely : sans aucun doute
Strong opinion : fort opinion
It is absolutely true that … : c'est absolument vrai que …
At all : du tout, à tout (ceci ne me derange pas du tout)
Entirely : entièrement
In a sense … : d’une certaine façon
I don’t quite agree with … : je ne suis pas assez (tout à fait) d'accord avec …
I’ve got mixed feelings about … : j'ai des sentiments mitigés à propos de ...
I agree but only to a certain point : je suis d'accord mais seulement jusqu'à un certain point
Accurate : précis
Unlike the author I believe that … : contrairement à l'auteur, je crois que
For instance : par exemple 				For example : par exemple
Unlike : contrairement à, different de
In addition : de plus
Moreover : de plus, en outre
Furthermore : de plus
Quality : qualité
Fashion : mode
Surfing on internet : surfer sur internet
Brands : marques
Popular : appprécié, populaire
Stand out the crowd : dermarquer de la foule		 Stand out : se démarquer, ressortir
Be noticed : être remarqué
Show off : frimer, se la péter
Attract attention : attire l’attention
Article : article
Peer : pair
Research : recherche					  To research : faire des recherches
Heavy : lourd
Profound : profond
Afford : s’offrir, avoir les moyens d’acheter
Fit in : s’intégrer
Influenced : influencé
Pressure : pression
Be isolated : être isolé
Significant : important
Upon : sur (on)
Room : pièce (espace)
Under immense pressure : sous une immense pression
Belong : appartenir, trouver sa place
To conclude : pour conclure
Child labour : travail des enfants
Labour : travail/parti ouvrier
Cheap labour force : main d’oeuvre pas chère
Poor : pauvre
Rich/wealthy : riche
Denunciation : dénonciation
Reflexion : réflexion
Claim : declaration, affirmation
Human rights : droits de l’Homme
Among : parmi, au milieu 
Fail : échouer
Ensure/Insure : assurer, couvrir
Minerals : minéraux
Component : composant
Firm : entreprise
Toward : vers, en direction de
Policy : politique
Testimony : témoignage
Allegedly : prétendument
Allege : prétendre
Orphan : orphelin
Relieve : soulager
Foster : encourager, promouvoir				Foster + parents = parents adoptifs
Reproach : reproche
Reproach : reprocher
Culprit : coupable
Opposite : opposé
Rule : règle, loi
Zero tolerance : zero tolerance
Warn /who/ that … : prévenir /quelqu’un/ que
Sunny : ensoleillé
Rainy : pluvieux
Cloudy : nuageux
Stormy : orageux
Snowy : negeux, ennaigé
Develop an interest in music : 
Peer : pair, amis 
To taste : goûter 						Taste : goût 
Taste in music : goûts musicaux
To relax : se détendre, relaxer
Put something online : mettre quelque chose en ligne
eighties (80’s) music : musique des année 80
Eighty : singulier -> Eighties : pluriel
(Make) accompaniment : (faire un) accompagnement
To concentrate : se concentrer
People /pipul/ : personnes
Pupil /pioupul/ : élève
Above : au-dessus de
Comparative : comparatif
To browse : regarder, jeter un oeil
Browse : recherche 
Council : conseil
Through : à travers
Weather : temps, météo
To weather : resister à, se degrader, s’user
Able : capable
Able to do : capable de faire 
Raven : corbeau
Cow : vache
Certain/Sure : certain, sûr
Some : quelques, certains 
Some friends are tall : certains de mesa mis sont grands 
Narrow : étroit
To solve : résoudre
To listen to : écouter
To perform : jouer(un spectacle,une musique), accomplir
To gather : rassembler 
Gathering : rassemblement, rénion
Concert : concert
To depend : dépendre
Mood : humeur
Caviar : caviar
Mushroom : champignon
Charlotte Cake : charlotte 
Unusual : inhabituel		  Usual : habituel 	   Usually (adv. Fré.) : en général
Memory : mémoire
Read /reed/ ; read /red/ ; read/red/ : écrire 
Present Perfect Simple	Past Simple
S + Have (present) + Part. PASSE	S + V (au prétérit)
Pour décrire un acte récent	Pour raconteur une action finie
I have just bought a piano.	I bought a piano two years ago
Ne peut pas être utilié avec une date	Peut être uilisé pour citer une date
FAUX : I have bought it three days ago (Present Perfect) .
TRUE : I bought it three days ago (Past Simple).	I began four years ago
Meals /
-	Starter : entrée 
-	Main course : plat principal
-	Dessert : dessert
Pie : tarte
Pastry : pâte, patisserie(la nourriture)
	La difference entre Bake et Cook : cuisiner :
-Bake : utiliser pour les desserts 
-Cook : utiliser pour les plats principaux 
To bake a cake : cuisine/cuire un gâteau		         To cook a stew : cuisiner/cuire un ragoût
Sweet : sucré
Savoury : qql. qui n’est pas sucrée
Savoury : savoureux 
To review : verifier
To check out : vérifier
Dish : plat, vaiselle
	If et Whether (si) :
If	Whether
Utilisé quand il y a une condition	Utilisé : -soit pour le doute
  Soit comme preposition (le reste)
Condition :
I can go to London if I get the money.
//Je peux aller à Londre si j’obtiens l’argent.//	Doute :
 Tell me whether you are coming or not.
//Dis-moi si tu est entrain de venir ou non.//
Préposition (le reste) :
 I need to know whether Rachel will go.
//J’ai besoin de savoir si Rachel partira.//

Would like : j’aimerais
Would : je voudrais
Surroundings : les environs, alentours
To surround : encercler, entourer 
While : tant que, pendant que
Pretty : joli, mignon
Fancy : chic, de luxe
On the other hand : d’un autre côté, par contre
	Il y a :
-Ago : utilise pour les dates (se place à la fin de la phrase)
-There is/There are : utilisé pour un nom et pour le reste
Three month ago : Il y a trois mois 				There is a car : Il y a une voiture
	Depuis :
Since : exprime une durée en partant d’une date de départ / Depuis + date de départ (2018)
For : exprime une durée en partant d’une date de fin / Depuis + durée (2 ans)
He is raining for 1 week / Since the last Monday, he is raining 
Hushed : feutré						             Hush : chut, tais-toi
To serve : servir 
To propose : proposer 
What do you do for a living ? : comment gagnez-vous votre vie
A course : un cours
Stiff : rigide, courbaturé
Housework : ménage
Model : modèle	 / miniature					To model : être manequin
Plane : Avion 
Model plane : avion miniature
Low : bas							Lowest : le plus bas
Grade : note, classe
Furniture : meuble
Word : mot							Work : travail / travailler
World : monde
	Le devoirs :
-Must/Mustn’t + BV : Utilisé au present /Un acte qui est rendu obligatoire par une loi/
-Have to + BV : Utilisé au present /Une obligation que quelqu’un a dit : qui n’est pas éccris dans la loi/
-Shall :
Kind of wood : watégorie de bois
Kind : chaleureux, aimable
Kind /kaind/ : catégorie, sorte/genre
Hole : trou
Somebody : quelqu’un						Nobody : personne
Someone : quelqu’un
To make an appointment : prendre rendez-vous
Appointment : rendez_vous, affection (nomination)
Way of + V-ing : façon de …
Way of saying : façon de parler
I need to find a way of making some money fast : J’ai besoin de trouver une façon de faire un peu de money rapidement
To arrange : arranger
To cry : pleurer
Sell/sold/sold : vendre
Sale : la vente
Children’s choir : la chorale d’enfant
Chain : chaîne (entreprise et collier)
To offer : offrir
I can’t put the book down : je ne peux pas arrêter de lire
To realize = To realise
To realize : se render compte de, réaliser   
My head was stuck in a book : Ma tête était collée dans le livre/Je n’arrivais pas a arrêter de lire
To take [something] up : se mettre à, commencer à
Basic /baysic/ : élémentaire
One /won/ : un
Key /kee/ : clé
Keyboard /Kiiboard/ : clavier
Time flies : le temps passe vite
Flies = fly 3ème p. Singulier
	Les goûts :
To love = To be crazy about : adorer
To like = To be keen on = To be fond of : aimer
To don’t like = To be not really fond of : ne pas vraiment aimer
To hate : detester
	Le verbe qui suit les expressions ci-dessus es ten -ING : Love + B.V. -ing
Several : plusieurs
Which ones ? : Lesquels ?
Well : bien
A rock band : groupe de rock
Especially : particulièrement
How about that ! : ça alors !
How about that ? : qu’est que tu en penses ? 		             How about jazz : que penses tu du jazz
To admit : admettre 
Of course : bien sûr, évidemment
Obviously : évidemment
Lyrics : paroles
To mix : mélanger
To get [subject] mixed up : confondre
String : à corde
Stringed instrument : instrument à corde
Traceable : traçable, identifiable
Sound louder : sonner plus fort
Successful : (qui a) réussi
Successful song : chanson réussie
Tune : mélodie
To tune (music) : accorder (sa guitare)
To tune (machine) : régler (la TV)
Venue : lieu, salle
Event : évènement
Finger : doigt
Feature : caractéristique
Ten : dix
Each : chaque, chacun
Speech bubble : bulle
To cross : traverser, franchir
Cross : croisement
Cross : horizontal
To be angry about : Etre en colère (contre, à propos de)
To be worried about : Etre inquiet (de, a propos de)
To afraid of  + V – ing. : avoir peur de …
To be busy with : Etre occupé avec …
To bear with : patienter 
To look for : chercher
To wait for : attendre, patienter
Thrill : frisson, excitation
Thrill : sensation forte
Spine : volonté
According to : Selon
To seem : sembler
To look like : ressembler à
To look : sembler, paraitre, avoir l’aire
To open up : (s’)ouvrir -> se confier et bouger
Brain : cerveau
Area : zone
Adventure : aventure
To travel : voyager
Travel : voyage
Nine-to-five : (expression) qui fait ses 35 heures, travail
To range : varier
Range : gamme (série et limite)
The range of acceptable values is from … to … : La gamme des valeurs admissibles va de … à …
Huge : énorme
Scuba diving : plongée sous-marine
Kayaking : (faire du) kayak
Cruise : croisière
Land : terre, sol
Wonderful : merveilleux, execptionnel
Wildlife : faune (animaux)
Whale : baleine
Trek : Randonnée
To sail on the lake : naviquer sur le lac
Sea : mer
Teddy : ours en peluche
Cuddly toy : peluche
Benefit : bénéfice
Advantage : avantage
Abroad : à l’étranger
I rarely go abroad : je vais rarement à l’étranger
Surrounded by nature : entouré par la nature
Hustle and bustle : animation, agitation, tohu-bohu
Away : absent, loin (from : de)
To take a look : jeter un œil
To browse : jeter un œil, rechercher
If so : si oui
Across : à travers 					To cross : traverser
Stream : ruisseau
Mosquito : moustique
Nurse : infirmière
To increase : augmenter
To rise/rose/risen : augmenter
To pull : tirer
To give [sth] up : abandonner 
To carry on : continuer
To fall into : tomber dans
Blind : aveugle
Apart : séparé 
To jab : piquer (planter une aiguiller)
Discount : remise, réduction
Shopkeeper : commerçant
Retailer : petit commerçant
Price cut : baisse de prix
To spread/spread/spread : se propager, se répandre
Each other over : les uns sur les autres
Other : autre
Over : au-dessus, terminer
To argue : se disputer
To catch up : rattraper
To laugh : rire, rigoler
To pay tribute : rendre hommage
Honour : honneur
Wedding : mariage
Daughter : fille
Granddaughter : petite-fille 
Son : fils
Grandson : petit-fils
Guest : invité, convive
To due to take place : qui doit avoir lieu
Politician : politicien
To deliver a speech : prononcer un discours
Meeting : reunion
Council : conseil (comité)
Freedom : liberyé
To adrift : à la dérive
Callousness : insensibilité, cruauté
To squeeze : presser (avec la main)
Oil : pétrole
Fossile energy : énergie fossile
To overshoot [sth] : dépasser qqch 
To use up : épuiser (une resource)
Lockdown : coonfinement
Infirmary : infirmerie
I’d : Contraction de would
Rather : plutôt
I’d rather : Je préférerais
See you later : A plus tard !
See you next week : A la semaine prochaine
Diary : Agenda, Calendrier / Journal intime
Notebook : cahier
Contact book : carnet d’adresse
Can I put my tissue in the bin ? : Puis-je mettre mon mouchoir à la poubelle
I haven’t finished yet : Je n’ai pas encore fini
I can borrow a dictionary ? :  Puis-je emprunter un dictionnaire
It’s too bright. Could you pull down the blinds, please ? : C’est trop lumineux. Pouvez-vous tirer les rideaux, s’il vous plait ?
To pull : Tirer (déplacer)
To step aside : S’écarter
To wipe the board : Essuyer le tableau
Can I give out the worksheets : Puis-je distribuer les feuille de travail
To hand out : Distribuer
To distribute : Distribuer
Is it graded ? : C’est noté
Mark : Marque, trace
To grade : noter
Is it my turn to speak : Est-ce à mon tour de parler 
How much time do we have left ? : combine de temps nous reste-t-il ?
Instructions : Instructions
To look at :
To look after :
To look forward to + V-ing :
To get rid of … :
Will be allowed to … :
Chil/children :
Man/men :
Woman/women :
Leaf/leaves :
	Further or Farther :
Farther : plus loin, est utilisé quand il s’agit d’une distance
Further : plus loin, est utilisé pour le reste (For further information, please contact us)
	Must au Futur et Passé :
Must ≈ Have to
He had to leave early :
He will have to do his test tomorrow :
Blow/blew/blown : souffler
To overlook [sth] : ignorer, surplomber
Forbid/Forbade/Forbidden : interdire
Forecast/Forecast/Forecast : prévoir
Proofread/Proofread(red)/Proofread(red) : relire
Deal/Dealt/Dealt : traiter, distribuer
Bet/Bet/Bet : parier
Bind/Bound/Bound : relier 
Bite/Bit/Bitten : mordre
Bleed/Bled/Bled : saigner
Burst/Burst/Burst : éclater
Burst into (the room) : faire irruption (dans la pièce)
Forgive/Forgave/Forgiven : pardoner
Freeze/Froze/Frozen : geler, se figer
Hang/Hung/Hung : accrocher
Lay/Laid/Laid : poser
Lay the table : mettre la table
Lie/Lay/Lain : être étendu
Rent/Rent/Rent : louer
Ring/Rang/Rung : sonner, telephoner
Shake/Shook/Shaken : secouer
Shine/Shone/Shone : briller (le soleil)
Smell/Smelt/Smelt : sentir (odorat)
Tear/Tore/Torn : déchirer
Upset/Upset/Upset : contrarier
To make fun of : se moquer de
To Have fun : s’amuser
Glass : verre
Party : fête
Confetti : confettis
Balloon : ballon de baudruche
Entertaining : divertissant
Gutted : vidé
The cartoon illustrates … : Le dessin illustre …
Real situation : situation réel
Voter : électeur
Poll : vote, scrutin
Polling station : bureau de vote
Candidate : candidat
Incumbent : sortant (fin de mandate)
Term : période
Primary : primaire
Caucus : election primaire
To disrupt : pertuber
To cancel : annuler
Convention : convention
To delegate : déléguer
Physical : physique
Running mate : candidat à la vice-présidence
Platform : programme, estrade/quai (gare)
Promise : promesse
To put in place : mettre en place
Volunteer : volontaire, bénévole
Citizen : citoyen
Allegiance : allégeance
To hope : espérer
To refer : faire reference à, concerner
Electoral college : college electoral (groupe de personne qui participent à l’élection)
Party policies : partie politique
The flag alternating red and white stripes : le drapeau alternant des rayures rouges et blanches
To pledge : promettre
Pledge : promesse
Former : ancient (ex-)
Otherwise : sinon
Wife : femme, épouse
Ballot : scrutin
To have covered :
To neglect : négliger
Prior : precedent, avant
To put it another way : en d’autres termes
All over : partout
Everywhere : partout
Law : loi
To run for : se presenter
Outsider : étrangers
Such as : tel que, comme(≈like)
Unless : à moins que
To involve : impliquer
Once : une fois que
As against : en opposition à
On the contrary : au contraire 
In contrast to : en contraste avec
To advocate :
Heaven : paradis
Under : sous
Below : en dessous
On/Upon : sur
Above : au dessus
Dreamer : rêveur
Hunger : faim
Famine : famine
Appetite : appétit
Greed : gourmandise
War : guerre
Peace : paix
Brotherhood : fraternité
To murder : assassiner, tuer
To kill : tuer
Faith : conviction
Religion : religion
To worship : prier un Dieu
Spread out : étendre
Settle down : s’installer
Settler : colonisateur
Colonist : colon
Colonizers : colons
Wiped out : épuisé
Hike : Randonnée			To hike : faire de la randonné 
I only hiked five miles but it feels more like twenty : I'm wiped out : Je n'ai marché que 8 km mais j'ai l'impression d'en avoir fait 30 : Je suis épuisé !
Eraser : gomme 
To complain : se plaindre
To set sail : prendre la mer
Overcrowd : surpeupler
Storm : orage
To hamper : ralentir, freiner
Shelter : abri, refuge
House : maison
Blow off : laisser tomber
Give [sth] up : abandonner
Tribes : tribues
Hunter : chasseur
To adapt : adapter
Hundred : cent, 100
To record : enregistrer
Feast : festin
To attend : assister à, aller à
To occupy (ied) : occuper
Harvest : moisson
Crop : récolte
To partake : participer
Entertainment : divertissement
Entertaining :  divertissant
Venison : chevreuil
Headlined : gros titre
Although : bien que
I speak lot with them although I don’t see them much : je parle beaucoup avec eux même si je ne les vois pas beaucoup
Land : terre
Eyewitness : témoin oculaire
Reservation : reservation 
To massacre : massacre
To interview : interroger
Drug addiction : addiction à la drogue
Domestic violence : violences conjugales
Unemployment : chômage
Jail : prison
Prison : prison
Below : en dessous
Deck : pont
Bridge : pont
Sight : vue
Enough food : suffisamment de nourriture 
Church : église
Grateful : reconnaissant
Plenty of : beaucoup de
To mourn : pleurer, être en deuil
Day of mourning : jour de deuil
Oppression : oppression
Theft : le vol (stealing)
Strike/Struck/Struck : frapper, passer un accord
Recognition : reconnaître
To provide : fournir
To wonder : se demander
Lonely : seul
Famous : célèbre
amount : quantité					To amount : s’élever à (le prix), devenir 
To Endanger : mettre en danger
Outbreak : épidémie, débordement
Pandemic : pandémie
Wide : large, grande
To store [sth] : garder [qql]
Store : magasin
Hence : d’où, d’ici
Compulsory : obligatoire
Guilty of : coupable de
To accuse : accuser
To riot : émeute
Demonstration : manifestation
To nab : voler, piquer
To hole up : se cacher
To spark : déclencher, faire des étincelles
Spark : étincelles
To trigger : déclencher, provoquer
To injure : blesser (like hurt)
Trailblazer : pionnier, pionnière
To appoint : nommer
Help the other : aider les autres
Use my mobile phone less :utilizer moins mon telephone portable
Get good marks : Avoir de bonnes notes
Grade : classe, note
To tell lies : mentir
To gossip : dire des ragots, bavarder
To improve : s’améliorer
Be grumpy : être grincheux
Be rude : être impoli, vulgaire
Do my best : Faire de son mieux
It rains cats and dogs : Il pleut des cordes
Quit/quit/quit + V-ing : quitter
Be kinder : être gentil
Daily : journalier, quotidien
Daily chores : corvée quotidienne
Remote learning : apprentissage à distance
Remote + act : à distance
To extend : agrandir (espace)
Stop + V-ing : Arrêter de …
Stop + to BV : S’arrêter pour …
Be more caring : être plus attentionné
Blind : aveugle						   Blind : store, rideaux
Hang up : raccrocher, suspender (vêtements)
Put back : remettre
To tidy : ranger
Spot : bouton					 	   Spot : endroit
Feel rotten : se sentir mal
Trousers : pantalon
Ignorant : ignorant
Relevant : pertinent 
Significant : important
Vow : un vœu						   To vow to do : jurer de faire …
To bark : aboyer
Once : Une fois que…					   Once : une fois par…
I going to do exercise once a week : Je vais faire de l’exercice une fois par semaine
	Passif :
Pour construire une phrase au passif en anglais, il faut prendre une phrase, identifier le temps du verbe puis conjuger be à ce temps et mettre le verbe au participe passé :
Be (conj like last phrase) + Participe passé
He ate a cake -> Prétérit -> A cake was eaten (by him)
Joe is driving a car -> Ps Be -ing -> A car is being driven by Joe
-	Quand on a 2 complément :
Joe offered her a present -> 2 comp : her  +  a present
A present was offered to her (by Joe)
She was offered a present (by Joe)
I want to + BV : je veux … 
I will + BV : je + future …
I won’t + BV : je ne + futur …
I am going to + BV : je suis sur que je + futur …
I should + BV : Je devrais …
I would like + BV : J’aimerais …
I plan on + V-ing : Je compte faire …
I resolve to + BV : Je suis résolut de …
I intend to + BV :  J’ai l’intention de …
I commit myself to : Je m’engage à …
I promise to + BV : Je promets que je …
I am about to + BV : Je suis sur le point de 
I hope to + BV : J’espère que …
	The different jobs 
Electrician : électricien
Plumber : plombier
Gardener : jardinier
Lumberjack : bucheron
Florist : fleuriste
Mechanic : un mécanissien
Hairdresser : coiffeur
Construction worker : ouvrier du bâtiment
Builder : maçon
Baker : boulanger
Pastrycook : pâtissier
Butcher : boucher
Dustman : éboueur
Fisherman : pêcheur
Postman : postier/facteur
Architect : architect
Politician : politician
Cleaning lady : femme de ménage
Cleaner : nettoyeur
Cook : cuisinier
Waiter : serveur				Waitress : serveuse
Dentist : dentiste
Actress : actrice					Actor : acteur
Musician : musicien
Singer : chanteur
Doctor : médecin
Vet : vétérinaire
Surgeon : chirurgien
Nurse : infirmier
Chemist : pharmacien					Pharmacist : pharmacien
Psychologist : psychologue
Biologist : biologiste
Optician : opticien
Engineer : ingénieur
Fireman : pompier
Pilot : pilote
Policeman : agent de police, policier
Soldier : soldat
Cashier : caissier
Film director : réalisateur
Headmaster : directeur
Businessman : homme d’affaire
Sculptor : sculpteur
Salesman : vendeur
Farmer : fermier
Lawyer : avocat
Solicitor : notaire
Judge : juge
Accountant : comptable
Lifeguard : un maître nageur 
Web designer : créateur de site internet
To apply for a job : postuler pour un employ
To job hunter : chercher un emploi
Hunter : chasser
Cover letter : lettre de motivation
An employee : employé
An employer : employeur
A job applicant : un candidat
To hire : embaucher
To go through a job interview : passer un entretien
Intership : stage
To work at : travailler à
To work for a person : travailler pour
Firm/enterprise/company : entreprise
Hourly rate : paiement à l’heure
To achieve a goal=attain : atteindre son but
To resign : démissioner
	The experience can be___
Boring : ennuyeuse
Enriching : enrichissante
Exciting : passionnant
Interesting : intéressante
Repetitive : repetitive
Tiring : fatiguante
	The skill and Personality
Conscientious : consciencieux
Creative : créatif
Helpful : utile, veut aider
Hardworking : travailleur
Motivated : motivé
Outgoing : sociable, ouvert
Passionate about … : passioné sur…
Reliable : fiable
Responsible : responsable
Trustworthy : digne de confiance
Willing : bonne volonté
Cooperative : coopératif
Courageous : courageux
Agility : agile
Be able to manage a team : manager une équipe
Independent : indépendant
Good listerner : savoir écouté
Caring : attentionné
Intelligent : intelligent
Organized : organisé
Expectation : espoir, espérance
To push : pousser
Expect : sauf 
To drill : percer, faire faire des exercise
Drill : perceuse, exercice (training exercise)  
Paper round : livrer des journaux
Posh : distingué, chic
Menial job : travail subaltern (inférieur)
Rubbish : ordures
Landfill : décharge
To breath : respirer
Subsidiary : filiale 
Treatment : traitement
To sort : triet
Renewal : renouvellement
Board : tableau
Consistent : cohérent
Relevant : pertinant
Significant : important
Law : loi
To affect : affecter, toucher
Expendable : expansif
To fix : réparer
Mow/Mowed/Mown : tondre
Lawn : gazon
Never	Ever	Already
Signifie “jamais”	Signifie “toujours” ou “déjà” 	Signifie “déjà” 
Utiliser dans les phrases négatives ou de sens négatif	Utiliser dans les phrases interrogatives (et affirmatives)	Utiliser dans les phrases affirmative (et interrogatives).
Trip : voyage					 	Journey : voyage
Travel : voyager
The quality press : Presse de qualité
The popular press/Gutter Press : Presse Populaire/d’égout
Fancy : chic
To fancy [smb] : plaire à quelqu’un 
	Exprimer ce que l’on veut faire :
Sujet + Want/Would like + to + BV
	Exprimer ce que l’on veut que quelqu’un fasse :
Sujet + Want/Would like + to + Concerned Person (name or pronom complement) + to + BV
	Exprimer des attentes :
Sujet + Expect + Concerned Person (name or pronom comlément) + to + BV
	Be + VB-ing -> Action en cours de déroulement
I’m writing a cover letter : Je suis en train d’écrire une lettre de motivation
	Present Perfect :
Formation : 		Have (présent) + Vb au participe passé
Utilisé pour exprimer un lien entre le passé et le présent, il permet de faire un bilan de ses actions. Certains adverbes sont utilisé pour insiter sur ce bilan :
-	« ever » et « before » -> questions (ever dans le sens de déjà)
-	« already » -> phrases affimatives
-	« never » -> phrases négatives
Extract : extrait 				Excerpt : extrait
To put forward [smt] : proposer, se porter volontaire
To look forward to  : attendre avec impatience
Advertisement : publicité, annonce 
Resume : CV
Response : réponse
To look for … : chercher
Cover letter word helpful :
	How to start ?
Dear Sir/Madam : Cher M. Chère Mmd.
	Say what do you want ?
I’m writing to apply for the job of … which I saw advertised in the local paper : j'écris pour postuler au poste de… que j'ai vu annoncé dans le journal local
I’m writing in response to your job announcement for a (job/position) at (place) : J'écris en réponse à votre offre d'emploi pour un (emploi / poste) à (lieu)
	Introduce yourself
I’m … years old and I’m in high school/ a student at … : J'ai… ans et je suis au lycée / élève à…:
	Why did you choose this job ? Experience ?
This job seems perfect for me because … : Ce travail semble parfait pour moi parce que…
I’m interested in this position because my dream is to … : Ce poste m'intéresse car mon rêve est de…
I have never work as a (job) before, but I do have some work experience : Je n'ai jamais travaillé comme (emploi) auparavant, mais j'ai une certaine expérience de travail
I’m planning to study … next year, so this would be a fantastic experience for me : Je prévois d'étudier… l'année prochaine, ce serait donc une expérience fantastique pour moi
	Abilities :
I know how to … : Je sais comment faire pour … 		I can … : Je peux
I have already (+ participle passé) : J’ai déjà …
	What do you like doing ?
I enjoy working in a team/alone | inside/outside : J'apprécie travailler en équipe/seul  dedans/dehors
	Skills :
I trust you’ll find me … : J'espère que vous me trouverez…
	Availability :
I can work at weekends and during school holidays : Je peux travailler le week-end et pendant les vacances scolaires
I’m available every day after school from .. to .. and on … : Je suis disponible tous les jours après l’école du… au… et le…
I’m free on (day) from … to … : Je suis libre le (jour) du… au…
I’m willing to work really hard : Je suis prêt à travailler très dur
I think I would be great for this job : Je pense que je serais génial pour ce travail
Thank you for your time attention : Merci pour votre temps d'attention
I look forward to hearing from you soon : J'espère avoir de vos nouvelles bientôt
Yours faithfully / Yours truly / Yours sincerely : fidèlement, sincèrement
To carry [sth/sb] off : enlever, mener à bien
To round up : rassembler
To prompt : souffler (rafraichir la mémoire)
Prompt : rapide
Thus : par conséquent
To deem : estimer, juger
To judge :  juger
Unfamiliar : mal conny
To attempt to : tenter de
To try : essayer
To manage to [vb] : réussir à			To manage to pull : réussir à tirer
To manage : manager
Thrust : poussé
To trust : faire confiance
To swarm : grouiller (fourmiller)
The people swarm in the street : les gens grouillent dans la rue
To fate [sb] to do : destine [qql] de faire
Fate : destin
Duty : devoir
To get close : approcher
To strike up : entamer (commencer), engager (la conversation)
To take [smt] up : se mettre à
Friendship : amitié
To strengthen : renforcer
strength : force
Discrepancy : divergence
To be worth : valoir
Worth : valeur
Despite : malgré
To slid : glisser
Husband : mari
To blame : accuser, blamer
To occurred : se produire
At most : au plus
At least : au moins
At last : enfin
A lot of : beaucoup de
Few of : peu de
Bit of : un peu de
Whole : entier, totalité
Supper : souper
To whisper : chuchoter
Slight : léger
To lift out : sous-traiter
To wrap : emballer
Oven : four
Upstairs : à l’étage
Grocer : épicier
Can of peas : boîte de petits pois
To sob : sangloter
To weep : pleurer
To cry : pleurer
Gently : doucement, avec douceur
Corpse : corps, cadaver
Body : corps 
To kneel : s’agenouiller
Precinct : commissariat de police
To remain : rester
To stay : rester
Hospitality : hospitalité
To eat up : finir son assiette
Whoever : quiconque
To giggle : glousser
To murder : assassiner 
Murderer : meurtrier
